Stage 1
#####
#OBP#
#####
=====
Stage 2
  #######
###  O  ###
#    B    #
# OB P BO #
###  B  ###
 #   O  # 
 ########